d    -> tan                 tomo                lukin               moku
k    -> kama                ken                 kepeken             suli
f    -> mu                  sama                tu                  anu
j    -> jan                 pana                soweli              jo
s    -> sina                sona                seme                sitelen
l    -> li                  la                  lon                 lili
a    -> a                   ala                 ale                 ante
g    -> kin                 lape                sin                 lipu
h    -> telo                nasa                pini                nanpa
e    -> e                   lawa                kalama              kulupu
i    -> ike                 ilo                 ijo                 luka
r    -> pakala              suno                en                  awen
u    -> sewi                suwi                kon                 sike
w    -> wile                wan                 wawa                weka
o    -> o                   ona                 poka                olin
q    -> kasi                mama                moli                waso
p    -> pona                pi                  pilin               pali
t    -> toki                tawa                tenpo               taso
y    -> kute                insa                utala               kili
c    -> poki                len                 seli                kala
v    -> open                kiwen               pu                  linja
m    -> mi                  mute                ma                  musi
x    -> pimeja              alasa               mani                mun
z    -> ko                  pipi                uta                 sijelo
b    -> kule                pan                 unpa                meli
n    -> ni                  nimi                nasin               n
3    -> jaki                anpa                kijetesantakalu     esun
4    -> akesi               loje                monsuta             palisa
tab  -> supa                lete                mije                noka
mins -> laso                tonsi               walo                nena
2    -> jelo                sinpin              epiku               oko
5    -> ku                  lupa                selo                leko
del  -> namako              kipisi              lanpan              monsi
ins  -> soko                meso                misikeke            jasima
1    -> kokosila            cartouche_l         cartouche_r         -
